aa = PlayerContainer
ab = OptionButton
av = CompassTextureBinder
aw = TextureBinder
az = Dispenser
bb = ItemRenderer
bk = PlaceableTileItem
by = ThrownSnowball
cf = | Snowball or SnowballItem <-- Named it snowball for now
cp = Ghast
ck = | PlaceableTileItem or Recipe
cg = FlowingLavaTextureBinder
Requires Mixin => ch = DeathScreen
cv = TileRenderer
cz = ResourceDownloadThread
da = Screen
db = GameStartupErrorPanel
dc = ClientPlayer
dn = ParticleManager
dp = LadderTile
ds = PlayerRenderer
ei = LevelProperties
em = EntityCollisionParticle
eo = StoneTile
ew = WorldPopulationRegion
Requires Mixin => fd = Level
fk = GlassTile
fr = Skeleton
fq = OptionIds
fu = TitleScreen
g = Taiga
gb = Creeper
gc = ChatScreen
gi = Wolf
gk = SandTile
gl = FootstepParticle
gm = ItemType
gn = FallingTileRenderer
gs = Player
gz = Monster
hs = PortalTextureBinder
ht = Option
hl = ItemEntity
hy = PistonRendere
ia = GrassColour
if = FlowingLavaTextureBinder2
ii = WalkingEntity
in = MathsHelper
ix = PlayerInventory
iz = ItemInstance
ji = TextureManager
jc = EntityRegistry
No Mixin required => kd = Biome
ke = Button
kv = GameOptions
kx = ClientChunkCache
le = DoorTile
lm = Chunk
ls = LivingEntity
lw = Inventory
lx = FishHook
nh = TranslationStorage
nk = IceTile
nu = CompoundTag
os = class_520
ow = TileEntity
oz = PauseScreen
px = GameRenderer
qz = BowItem
ra = HandItemRenderer
ro = Textbox
rp = FluidTile
rq = SelectWorldScreen
sd = FireTextureBinder
sj = TextRenderer
sl = Arrow
sn = Entity
tc = FurnaceTile
th = EntityRenderDispatcher
to = DimensionFileChunkIO
tz = class_552
u  = RenderHelper
uu = Tile
uz = Zombie
ya = ZombiePigman