aa = PlayerContainer
ab = OptionButton
av = CompassTextureBinder
aw = TextureBinder
az = Dispenser
bb = ItemRenderer
bk = PlaceableTileItem
by = ThrownSnowball
cf = | Snowball or SnowballItem <-- Named it Snowball
cp = Ghast
ck = | PlaceableTileItem or Recipe <-- Named Recipe
cg = FlowingLavaTextureBinder
ch = DeathScreen
cv = TileRenderer
cz = ResourceDownloadThread
da = Screen
db = GameStartupErrorPanel
dc = ClientPlayer
dh = class_61
dk = class_66 <-- Should be "WorldRenderer" in MCP mappings but we already have a WorldRenderer Class in the mappings. Not to sure what up with this.
dn = ParticleManager
dp = LadderTile
ds = PlayerRenderer
ei = LevelProperties
em = EntityCollisionParticle
eo = StoneTile
ew = WorldPopulationRegion
fd = Level
fk = GlassTile
fr = Skeleton
fq = OptionIds
fu = TitleScreen
fw = class_108 <-- Should be "Pathfinder" in MCP mappings
g  = Taiga
gb = Creeper
gc = ChatScreen
gi = Wolf
gk = SandTile
gl = FootstepParticle
gm = ItemType
gn = FallingTileRenderer
gs = Player
gz = Monster
hr = class_266 <-- Should be "SoundPool" in MCP mappings
hs = PortalTextureBinder
ht = Option
hl = ItemEntity
hy = PistonRenderer
ia = GrassColour
ie = RedstoneItem
if = FlowingLavaTextureBinder2
ii = WalkingEntity
in = MathsHelper
ix = PlayerInventory
iz = ItemInstance
jc = EntityRegistry
jh = FoliageColour
ji = TextureManager
ju = FallingTile
kd = Biome
ke = Button
ku = ClockTextureBinder
kv = GameOptions
kx = ClientChunkCache
le = DoorTile
lm = Chunk
ls = LivingEntity
ll = TileEntityRenderDispatcher
lw = Inventory
lx = FishHook
mg = <-- Not mapped yet, seems to be a weird case "SelectWorldScreen$class_569" in MCP its called "GuiWorldSlot"
n  = WorldRenderer
nh = TranslationStorage
nk = IceTile
nj = VideoSettingsScreen
nu = CompoundTag
ob = ClientInteractionManager <-- Should be "PlayerController" in MCP mappings
oh = FlowingWaterTextureBinder
om = FlowingFluidTile
or = CactusTile
os = class_520
ow = TileEntity
oz = PauseScreen
ps = | ModelPart or PaintingItem <-- Named it ModelPart
px = GameRenderer
qd = SwordItem
qm = TileParticle
qv = Painting
qz = BowItem
ra = HandItemRenderer
rb = Forest
ro = Textbox
rp = FluidTile
rq = SelectWorldScreen
sd = FireTextureBinder
sj = TextRenderer
sl = Arrow
sn = Entity
ss = StairsTile
st = LightCalculator
t = Hell
tc = FurnaceTile
th = EntityRenderDispatcher
to = DimensionFileChunkIO
tz = class_552
u  = RenderHelper
ue = PlayerInventoryScreen
uq = Overlay
uu = Tile
uw = Slime
uz = Zombie
vs = FlowingWaterTextureBinder2
wa = ArmourItem
wp = GrassTile
wq = FlyingEntity
xa = Dimension
xq = DispenserTile
xv = BiomeSource
ya = ZombiePigman
yf = OverworldLevelSource
yk = Sign
yq = FireTile
yo = SoundHelper
vv = ThrownEgg